111111111
1000000C1
100000001
1P00000E1
111111111