1111111111111111111111111111111111
1C000000000000000000000000000000E1
1000000000000000000000000000000001
1001100100010011110010000101111001
1010010100010100001010000101000101
1010010100010100001010000101000101
101111001C100100001010000101111101
1010010001000100001010000101000101
101CC1000100010000101CCCC101000101
101CC10001000011110001111001111001
1000000000000000000000000000000001
1P000000000000000000000000000000C1
1111111111111111111111111111111111