111111111111
100000C00001
1PP0000000E1
111111111111